*X*******
*       *
*       *
***   *1*
*1*   * *
*******Y*